NO ./img/north_64.xpm

WE ./img/weast_64.xpm

EA ./img/east_64.xpm

SO ./img/south_64.xpm

F 220,100,0

C       225,30,0


        1111111111111111111111111     11111111111111111111
        1000000000110000000000001      11      1111     11
        1011000001110000000000001     10011111100011111101
        1001000000000000000000001      11      1111111111
111111111011000001110000000000001
100000000011000001110111111111111
11110111111111011100000010001
11110111111111011101010010001
11000000110101011100000010001
10000000000000001100000010001
100000000000N0001101010010001
1100000111100101111101111000111
11110111 1110101 1011110100011
11111111 1111111 111111111111
