NO ./img/Old_Print_Dark_00.tif

WE ./img/Old_Print_Dark_02.tif

EA ./img/Dungeon_Grifts.tif

F 220,100,0

C       225,30,0






SO ./img/Old_Print_Dark_01.tif

        1111111111111111111111111     11111111111111111111
        1000000000110000000000001      11      1111      1
        1011000001110000000000001     10011111100011111101
        1001000000000000000000001      11      1101111111
111111111011000001110000000000001
100000000011000001110111111111111
11110111111111011100000010001
1111D111111111011101010010001
11000000110101011100000010001
10000000000000001100000010001
10000000000000001101010010001
1100000111100101111101111000111
11110111 1110101 1011110100011
11111111 1111111 111111111111
