NO ./img/north_64.xpm
SO ./img/south_64.xpm
WE ./img/weast_64.xpm
EA ./img/east_64.xpm

F 23,10,20
C 190,1,0

111111111111111111111111
100000000000000000000001
100000000000000000000001
100000000000000000000001
100000110110000101010001
100000110110000000000001
100000100010000110110001
100000110110000000000001
100000110110000110110001
100000000000000000000001
100000000000000000000001
100000000000000000000001
101000000000000000000001
10000000N000001000000001
100000000000000000000001
100000000000000000000001
111111111000000000000001
110100001000000000000001
110000101000000000000001
110100001000000000000001
110111111000000000000001
110000000000000000000001
111111111000000000000001
111111111111111111111111