NO ./img/north_64.xpm
SO ./img/south_64.xpm
WE ./img/weast_64.xpm
EA ./img/east_64.xpm

F 23,10,20
C 190,1,0



 1111111
100N00001
111111111